0,0,0,0,0,0,0,0,0,0,0,0,0,1,1,0,0,0,0,0,0,0,7,7,7,7,7,7,7,7,7,7,7,7,7,0,0,5,5,5,5,5,5,5,5,5,5,5,5,5,0,0,0,0,0,0,0,0,0,0,0,0,1,1,0,5,5,5,5,3,3,3,3,3,3,3,3,3,3,3,3,3,3,3,3,5,5,5,5,5,5,5,5,5,5,6,6,6,6,6
0,0,0,0,0,0,0,0,3,0,0,0,0,1,1,0,0,0,0,0,0,0,7,7,7,7,7,7,7,7,7,7,7,7,7,0,5,5,5,5,5,5,5,5,5,5,5,5,5,5,5,0,0,0,0,0,0,5,5,0,0,0,1,1,0,5,5,5,5,3,3,3,3,3,3,3,3,3,3,3,3,3,3,3,3,5,5,3,3,3,3,3,3,5,5,6,4,21,4,6
0,0,0,0,0,0,0,0,0,0,0,0,0,1,1,0,0,0,0,0,0,0,7,7,7,7,7,7,7,7,7,7,7,7,0,5,5,5,5,5,5,5,5,5,5,5,5,5,0,5,5,0,0,0,5,5,0,0,0,0,0,5,1,1,0,5,5,5,5,3,3,5,5,5,5,5,5,5,5,5,5,5,5,3,3,5,5,3,3,3,3,3,3,5,5,6,4,4,4,6
0,0,0,0,0,0,0,0,0,0,3,0,0,1,1,0,0,5,0,0,0,0,0,7,7,7,7,7,7,7,7,7,7,7,0,5,5,8,8,8,8,8,8,8,8,5,0,0,0,0,0,0,0,0,0,5,0,0,0,0,0,5,1,1,0,5,5,5,5,3,3,5,5,5,5,5,5,3,3,3,3,3,3,3,3,5,5,3,3,5,5,3,3,5,5,6,4,4,4,6
0,0,0,0,0,0,0,0,0,0,0,0,0,1,1,0,0,0,0,0,0,0,0,0,0,0,7,7,7,7,7,7,7,7,0,5,5,8,2,2,8,2,2,2,8,0,0,0,0,0,0,0,0,0,0,0,0,0,0,5,5,5,1,1,0,0,5,5,5,3,3,3,3,5,5,5,5,3,3,3,3,3,3,3,5,5,5,3,3,5,5,3,3,5,5,5,6,4,6,5
0,0,0,0,0,0,0,0,0,0,0,0,0,1,1,0,0,0,0,0,0,0,0,0,0,0,7,7,7,7,7,7,7,7,0,5,5,8,2,2,2,2,2,2,2,1,1,1,1,1,1,1,1,1,1,1,1,1,1,1,1,1,1,1,0,0,5,5,5,3,3,3,3,3,3,5,5,3,3,5,5,5,5,5,5,5,5,3,3,5,5,3,3,5,5,5,3,3,5,5
0,0,0,0,0,1,1,1,1,1,1,1,1,1,1,0,0,0,0,0,0,0,0,0,0,0,0,7,7,7,7,7,7,7,0,5,5,8,2,2,2,2,2,2,2,1,1,1,1,1,1,1,1,1,1,1,1,1,1,1,1,1,1,1,1,0,0,5,5,5,5,5,3,3,3,5,5,3,3,5,5,5,5,5,5,5,5,3,3,5,5,3,3,3,3,3,3,3,5,5
0,0,0,0,0,1,8,8,8,8,8,8,8,1,1,0,0,0,0,0,0,0,5,0,0,0,0,7,7,7,7,7,7,7,0,5,5,8,2,2,8,2,2,2,8,0,0,0,0,0,0,0,0,0,0,0,5,5,0,0,0,0,1,1,1,0,0,5,5,5,5,5,5,3,3,5,5,3,3,5,5,5,5,5,5,5,5,3,3,5,5,3,3,3,3,3,3,3,5,5
0,0,0,0,0,1,8,2,2,8,2,2,8,1,1,0,0,0,5,0,0,0,0,0,0,0,0,0,7,7,7,7,7,7,0,5,5,8,8,8,8,8,8,8,8,5,0,0,0,5,5,0,0,0,0,0,0,5,5,0,0,0,0,1,1,1,0,5,5,5,5,5,5,3,3,5,5,3,3,3,3,3,3,3,3,5,5,3,3,5,5,5,5,5,5,5,5,3,5,5
0,0,0,3,0,1,8,2,2,8,2,2,8,1,1,0,0,0,0,0,0,0,0,0,0,0,0,0,7,7,7,7,7,7,0,0,5,5,5,5,5,5,5,5,5,5,0,0,0,0,0,0,0,0,0,0,0,0,0,5,0,0,0,1,1,1,1,0,5,5,5,5,5,3,3,5,5,3,3,3,3,3,3,3,3,3,5,3,3,5,5,5,5,5,5,5,5,5,5,5
0,0,0,0,0,1,8,2,2,8,2,2,8,1,1,0,0,0,0,0,0,0,0,0,0,5,0,0,7,7,7,7,7,7,7,0,0,0,5,5,0,0,0,5,5,0,0,0,0,0,0,0,0,0,0,0,0,0,0,5,0,0,0,0,1,1,1,0,0,5,5,5,5,3,3,5,5,5,5,5,5,5,5,5,3,3,5,3,3,3,3,3,3,3,3,3,5,5,5,5
0,0,0,0,0,1,1,1,1,1,1,1,1,1,1,0,0,0,0,0,0,0,0,0,0,0,0,0,0,0,7,7,7,7,7,0,0,0,0,0,0,0,0,0,0,0,0,0,0,0,0,5,0,0,0,0,0,0,0,0,5,5,0,0,0,1,1,0,0,0,5,5,5,3,3,5,5,5,5,5,5,5,5,5,3,3,5,3,3,3,3,3,3,3,3,3,5,5,5,5
0,0,0,0,3,1,8,2,2,8,2,2,8,1,1,0,0,0,0,0,0,0,0,0,0,0,0,0,0,0,0,7,7,7,7,7,7,0,0,0,0,0,0,0,0,0,0,0,0,0,0,0,0,0,5,5,0,0,0,0,0,0,0,0,0,1,1,0,0,0,5,5,5,3,3,3,3,3,5,5,5,5,5,5,3,3,5,5,5,5,5,5,5,5,3,3,5,5,5,5
0,0,0,0,0,1,8,2,2,8,2,2,8,1,1,0,0,0,0,0,5,0,0,0,0,0,0,0,0,0,0,0,0,7,7,7,7,7,7,7,0,0,0,0,0,0,0,0,0,0,0,0,0,0,0,5,0,0,0,0,0,0,0,0,0,1,1,0,0,0,0,5,5,5,3,3,3,3,3,3,3,5,5,5,3,3,5,5,5,5,5,5,5,5,3,3,5,5,5,5
0,0,0,0,0,1,8,8,8,8,8,8,8,1,1,0,0,0,0,0,0,0,0,5,5,0,0,5,0,0,0,0,0,7,7,7,7,7,7,7,0,0,0,0,0,5,0,0,0,0,5,0,0,0,0,0,0,0,0,0,0,0,0,0,0,1,1,0,0,0,0,5,5,5,5,5,3,3,3,3,3,5,5,5,3,3,3,3,3,3,3,3,3,5,3,3,3,3,3,5
0,0,0,0,0,1,1,1,1,1,1,1,1,1,1,0,0,0,0,0,0,0,0,5,5,5,0,0,0,0,0,0,0,0,0,7,7,7,7,7,7,0,0,0,0,0,0,0,0,0,0,5,5,0,0,0,0,0,0,0,0,0,0,0,0,1,1,1,0,0,0,5,0,5,5,5,5,5,3,3,3,3,5,5,5,3,3,3,3,3,3,3,3,5,3,3,3,3,3,5
0,0,0,0,3,0,0,0,0,0,0,0,0,0,1,1,0,0,0,0,0,0,0,5,5,5,5,0,0,0,0,5,0,0,0,0,7,7,7,7,7,0,0,0,0,0,0,0,0,0,0,0,5,0,0,0,0,0,0,0,0,0,0,0,0,1,1,1,0,0,0,0,5,0,5,5,5,5,5,5,3,3,3,5,5,5,5,5,5,5,5,3,3,5,5,5,5,3,3,5
0,0,0,0,0,0,0,0,0,0,3,0,0,0,1,1,1,0,0,0,3,0,0,0,5,5,5,5,0,0,0,0,0,0,0,0,7,7,7,7,7,0,0,5,0,0,0,0,0,0,0,0,0,5,5,0,0,0,0,0,0,0,0,0,0,1,1,1,0,0,3,0,0,5,5,5,5,5,5,5,3,3,3,5,5,5,5,5,5,5,5,3,3,5,5,5,5,3,3,5
0,0,0,0,0,0,0,3,0,0,0,0,0,0,1,1,1,1,0,0,0,0,0,0,5,5,5,5,5,0,0,0,0,0,0,0,0,7,7,7,7,0,0,0,0,0,0,5,5,5,0,0,0,0,0,0,0,0,0,0,0,0,0,0,0,1,1,1,0,0,0,0,0,0,5,5,5,5,5,5,3,3,3,3,3,3,3,3,3,5,5,3,3,5,5,5,5,3,3,5
0,0,0,0,0,0,0,0,0,0,0,0,0,0,0,1,1,1,0,0,0,0,0,0,0,0,5,5,5,5,0,0,3,0,0,0,0,0,7,7,7,0,0,0,0,0,5,5,5,5,0,0,0,0,0,0,0,0,5,5,5,5,0,0,0,1,1,1,0,3,0,0,0,0,5,0,5,5,5,5,3,3,3,3,3,3,3,3,3,5,5,3,3,3,3,3,3,3,3,5
0,0,0,0,5,5,0,0,0,0,0,0,0,0,0,0,1,1,1,0,0,0,0,0,0,0,0,5,5,5,5,0,0,0,0,5,0,0,7,7,7,7,0,0,0,0,5,5,5,5,0,0,0,0,0,0,0,0,0,0,5,5,0,0,0,1,1,0,0,0,0,0,0,0,0,5,0,5,5,5,5,5,5,5,5,5,3,3,3,5,5,3,3,3,3,3,3,3,3,5
0,0,0,0,5,5,0,0,0,0,0,0,3,0,0,0,0,1,1,1,0,0,0,0,0,0,0,5,5,5,5,5,0,0,0,0,0,0,0,7,7,7,0,0,0,0,0,0,0,0,0,0,0,0,0,0,0,0,0,0,0,0,0,0,0,1,1,0,0,0,0,0,0,0,0,0,5,0,5,5,5,5,5,5,5,5,5,3,3,5,5,5,5,5,5,5,5,5,5,5
0,0,0,0,5,5,0,0,0,0,0,0,0,0,0,0,0,0,1,1,1,0,0,0,3,0,0,5,0,5,5,5,0,0,0,0,0,0,0,7,7,7,7,0,0,0,0,0,0,0,0,0,0,0,0,0,0,0,0,0,0,0,0,0,1,1,1,0,0,0,3,0,3,0,0,0,0,5,5,5,5,5,5,5,5,5,5,3,3,5,5,5,5,5,5,5,5,5,5,5
0,0,0,0,5,5,5,0,0,0,0,0,0,0,0,0,0,0,1,1,1,1,0,0,0,0,0,0,5,5,5,5,5,0,0,0,3,0,0,0,7,7,7,0,0,0,0,0,0,0,0,0,0,0,0,0,0,0,0,0,0,0,0,0,1,1,0,0,0,0,0,0,0,0,0,0,0,0,0,5,5,5,5,5,5,5,5,3,3,3,3,3,3,3,3,3,3,3,5,0
0,0,0,5,5,5,5,5,0,5,0,0,0,0,0,0,0,0,0,1,1,1,0,0,0,0,0,0,0,0,5,5,5,0,0,0,0,0,0,0,0,7,7,7,0,0,0,0,0,0,0,0,0,5,5,5,0,0,0,0,0,0,0,0,1,1,0,0,0,0,0,0,0,5,5,5,0,0,0,0,0,5,5,0,5,5,5,5,3,3,3,3,3,3,3,3,3,3,5,5
0,0,5,5,5,5,5,5,0,0,0,0,0,0,0,0,3,0,0,0,1,1,0,0,0,0,0,0,0,0,0,5,5,5,0,0,0,0,0,0,0,7,7,7,7,0,0,0,0,0,0,0,0,0,0,0,0,0,0,0,0,0,0,0,1,1,0,0,0,0,0,0,0,5,5,5,0,0,0,0,0,0,0,5,5,5,5,5,5,5,5,5,5,5,5,5,3,3,5,5
0,5,5,5,5,5,5,5,5,0,0,0,0,0,0,0,0,0,0,0,1,1,0,0,0,0,0,0,0,0,0,0,5,5,5,0,0,0,0,0,0,0,7,7,7,7,0,0,0,0,0,0,0,0,0,0,0,0,0,0,0,0,0,0,1,1,0,0,5,0,0,0,0,0,0,5,5,0,0,0,0,0,0,0,0,5,5,5,5,5,5,5,5,5,5,5,3,3,5,0
0,0,0,5,5,5,5,5,5,5,0,0,0,0,0,0,0,0,0,0,1,1,1,0,0,0,0,0,0,0,0,0,0,5,5,5,5,0,0,5,0,0,0,7,7,7,0,0,0,0,0,0,0,0,0,0,0,0,0,0,0,0,0,0,1,1,0,0,5,0,0,0,0,0,0,0,0,0,0,0,3,0,0,0,0,0,0,0,5,5,5,5,5,5,5,0,5,0,0,7
0,0,0,5,5,5,5,5,5,5,5,5,5,5,5,0,0,0,0,0,0,1,1,0,0,0,0,0,0,0,3,0,0,0,5,5,5,0,0,0,0,0,0,7,7,7,7,0,0,0,0,0,0,0,0,0,0,0,0,0,0,0,0,0,1,1,0,0,5,5,0,0,0,0,0,0,0,0,0,0,0,0,0,0,0,0,0,0,0,5,5,5,5,5,5,5,0,0,0,7
0,0,0,0,0,5,5,5,5,5,5,5,5,5,5,5,0,0,0,0,0,1,1,1,0,0,0,0,0,0,0,0,0,0,5,5,5,0,0,0,0,0,0,7,7,7,7,7,0,0,0,0,0,5,5,5,5,5,0,0,0,0,0,0,1,1,5,5,0,5,0,0,0,5,5,0,0,0,0,0,0,0,0,0,0,0,0,0,0,0,0,0,0,0,0,0,0,0,7,7
0,0,0,0,0,0,5,5,5,5,5,5,5,5,5,5,5,0,0,0,0,0,1,1,1,1,1,0,0,0,0,0,0,0,0,0,0,0,0,0,0,0,0,0,7,7,7,7,0,0,0,0,0,5,5,5,5,5,0,0,0,0,0,0,1,1,0,0,5,5,5,5,5,5,0,0,0,0,0,0,5,5,5,0,0,0,0,0,0,0,0,0,0,0,0,0,0,0,7,7
0,0,0,0,0,0,5,5,5,5,5,5,5,5,5,5,5,5,5,0,0,0,0,0,1,1,1,1,1,1,1,0,0,0,0,0,0,0,0,0,0,0,0,0,7,7,7,7,0,0,0,0,0,0,5,5,5,0,0,0,0,0,0,0,1,1,0,5,5,5,5,5,5,5,0,0,0,0,0,5,5,5,5,5,5,0,0,0,0,0,0,0,0,0,0,0,0,7,7,7
0,0,0,0,5,5,5,5,5,5,5,5,5,5,5,5,5,5,5,5,0,0,0,0,0,0,0,1,1,1,1,1,0,0,0,0,0,0,0,0,0,0,0,0,0,7,7,7,0,0,0,0,0,0,0,0,0,0,0,0,0,0,0,0,1,1,0,5,0,0,5,5,5,5,5,0,0,0,0,0,0,0,0,0,0,0,0,0,0,0,0,0,0,0,0,0,0,7,7,7
0,0,0,5,5,5,5,5,5,5,5,5,5,5,5,5,5,5,5,5,5,5,0,0,0,0,0,0,0,0,1,1,0,0,0,0,8,8,8,8,8,8,8,0,0,0,7,7,7,0,0,0,0,0,0,0,0,0,0,0,0,0,0,0,1,1,0,5,5,5,0,0,0,5,0,0,0,0,0,0,0,0,0,0,0,0,0,0,0,0,0,0,0,0,0,0,7,7,7,7
0,0,5,5,5,5,5,5,5,5,5,5,5,5,5,5,5,5,5,5,5,5,5,5,0,0,0,0,0,0,1,1,0,0,0,0,8,2,2,8,2,2,8,0,0,0,7,7,7,7,0,0,0,0,0,0,0,0,0,0,0,0,0,0,1,1,0,0,0,0,0,0,0,0,0,0,0,0,0,0,0,0,0,0,0,0,5,5,5,5,5,5,0,0,0,7,7,7,7,7
0,0,5,5,0,5,0,0,0,0,0,0,5,5,5,5,5,5,5,5,5,5,5,5,5,5,0,0,0,0,1,1,0,0,0,0,8,2,2,8,2,2,8,0,0,0,7,7,7,7,0,0,0,0,0,0,0,8,8,8,8,8,8,8,1,1,8,8,8,8,8,8,8,8,8,0,0,0,0,0,0,0,0,0,3,0,0,0,0,0,0,0,5,5,7,7,7,7,0,0
0,0,5,0,0,0,3,3,3,3,3,3,0,5,5,5,5,5,5,5,5,5,5,5,5,5,5,5,0,0,1,1,0,0,0,0,8,2,2,2,2,2,8,0,0,0,0,7,7,7,0,0,0,0,0,0,0,8,2,2,2,2,2,8,1,1,8,2,2,2,2,2,2,2,8,0,0,0,0,0,5,0,0,0,0,0,0,0,0,0,0,0,0,7,7,7,7,0,0,0
0,0,5,0,3,3,3,3,3,3,3,3,3,3,0,0,5,5,5,0,0,0,5,5,5,5,5,5,0,0,1,1,0,0,0,0,8,2,2,2,2,2,8,0,0,0,0,0,7,7,7,0,0,0,0,0,0,8,2,2,2,2,2,2,1,1,2,2,2,2,2,2,2,2,8,0,0,0,0,0,5,5,0,0,0,0,0,0,0,0,0,0,0,7,7,7,0,0,0,0
0,5,5,0,3,3,8,8,8,8,8,8,8,3,3,3,3,0,0,0,0,0,0,0,0,0,0,0,0,0,1,1,0,0,0,0,8,8,2,2,2,8,8,0,0,0,0,0,0,7,7,0,0,0,0,0,0,8,2,2,2,2,2,2,1,1,2,2,2,2,2,2,2,2,8,8,0,0,0,0,5,5,0,0,0,0,0,0,0,0,0,0,7,7,0,0,0,0,0,0
0,5,5,3,3,8,2,2,2,2,2,2,2,8,8,8,3,3,3,3,0,0,0,0,0,0,0,0,0,5,1,1,5,0,0,0,0,0,0,0,0,0,0,0,0,0,0,0,5,7,7,5,0,0,0,0,0,8,8,2,2,2,8,8,1,1,8,2,2,2,8,2,2,2,2,8,8,8,0,0,0,0,0,0,0,0,0,0,0,0,0,7,7,0,0,0,0,0,0,0
0,5,3,3,8,2,2,2,2,2,2,2,2,2,2,2,1,1,1,1,1,1,1,1,1,1,1,1,1,1,1,1,1,1,1,1,1,1,1,1,1,1,1,1,1,1,1,1,1,2,2,1,1,1,1,1,1,1,1,1,1,1,1,1,1,1,2,2,2,2,8,8,2,2,2,2,2,8,0,0,0,0,0,0,0,0,0,0,0,0,7,7,0,0,0,0,0,0,0,0
0,5,3,3,8,2,2,8,2,2,8,2,2,2,2,2,1,1,1,1,1,1,1,1,1,1,1,1,1,1,1,1,1,1,1,1,1,1,1,1,1,1,1,1,1,1,1,1,1,2,2,1,1,1,1,1,1,1,1,1,1,1,1,1,1,1,2,2,2,2,2,8,2,2,2,2,2,8,0,0,0,0,0,0,0,0,0,0,0,7,7,5,0,0,0,0,0,0,0,0
0,5,3,3,8,2,2,8,2,2,8,8,8,8,2,2,8,1,5,3,0,0,0,0,0,0,0,0,0,5,1,1,5,0,0,0,5,0,0,0,0,0,0,0,0,0,0,0,5,0,7,7,0,0,0,0,0,8,8,2,2,2,8,8,1,1,8,2,2,2,2,2,2,2,8,2,2,8,0,0,0,0,0,0,3,0,0,0,0,7,7,0,5,5,5,5,5,0,0,0
0,5,3,3,8,2,2,2,2,2,2,2,2,2,2,2,8,1,5,3,0,0,0,0,0,0,0,0,0,0,1,1,0,0,0,0,0,0,0,0,0,0,0,0,0,0,0,0,0,0,7,7,7,0,0,0,0,8,2,2,2,2,2,8,1,1,8,2,2,2,2,2,2,2,2,2,2,8,0,0,0,0,0,0,0,0,0,0,7,7,0,0,0,0,0,0,0,0,0,0
0,5,3,3,8,2,2,2,2,2,2,2,2,2,2,8,8,1,5,3,0,0,0,0,0,0,0,0,0,0,1,1,0,0,0,0,0,0,0,0,0,0,0,0,0,0,0,0,0,0,0,7,7,7,0,0,0,8,2,2,8,2,2,8,1,1,8,2,2,2,2,8,2,2,2,2,2,8,0,0,0,0,0,0,0,0,0,0,7,7,0,0,0,0,0,0,0,0,0,0
0,3,5,3,8,8,8,8,8,1,1,8,8,8,8,8,1,1,5,3,0,0,0,0,0,0,0,0,0,0,1,1,0,0,0,0,0,0,0,0,0,0,0,0,0,0,0,0,0,0,0,0,7,7,0,0,0,8,2,2,2,2,2,8,1,1,8,8,2,2,2,8,8,2,2,8,8,8,0,0,0,0,0,0,0,0,0,5,7,5,0,0,0,0,0,0,0,0,0,0
0,5,5,3,1,1,1,1,1,1,1,1,1,1,1,1,1,5,5,3,0,0,0,0,0,0,0,0,0,0,1,1,0,0,0,0,0,0,8,8,8,0,0,0,0,0,0,0,0,0,0,0,7,7,0,0,0,8,2,2,2,2,2,8,1,1,1,1,1,1,1,1,1,1,1,1,1,1,1,1,1,1,1,1,1,1,1,2,2,1,1,1,1,1,1,1,1,1,1,1
0,0,5,3,1,1,1,1,1,1,1,1,1,1,1,1,1,5,3,0,0,0,0,0,0,0,0,0,0,5,1,1,5,0,0,0,0,0,8,0,8,0,0,0,0,0,0,0,0,0,0,0,0,7,7,0,0,8,8,8,2,2,2,2,1,1,1,1,1,1,1,1,1,1,1,1,1,1,1,1,1,1,1,1,1,1,1,2,2,1,1,1,1,1,1,1,1,1,1,1
0,0,0,3,3,3,3,3,3,3,3,3,3,3,3,3,3,3,0,0,0,0,0,0,0,0,0,0,0,0,1,1,0,0,0,0,0,0,0,0,0,0,0,0,0,0,0,0,0,0,0,0,0,7,7,0,0,0,0,8,2,2,2,2,1,1,8,8,2,2,2,8,8,2,2,8,8,8,0,0,0,0,0,0,0,5,7,7,0,5,0,0,0,0,0,0,0,0,0,0
0,0,0,0,0,0,0,0,0,0,0,0,0,0,0,0,0,0,0,0,0,0,0,5,0,0,0,0,0,0,1,1,0,0,0,0,0,0,0,0,0,0,0,0,0,0,0,0,0,0,0,0,0,7,7,0,0,0,0,8,8,2,2,8,1,1,8,2,2,2,2,2,2,2,2,2,2,8,0,0,0,0,0,0,7,7,7,0,0,0,0,0,0,0,0,0,0,0,0,0
7,7,7,7,7,7,7,7,7,0,0,0,0,0,0,0,0,0,0,0,0,0,0,0,0,0,0,5,0,0,1,1,0,0,0,0,0,0,0,0,0,0,0,0,0,0,0,0,0,0,0,0,0,0,7,7,0,0,0,0,8,2,2,8,1,1,8,2,2,2,2,8,2,2,2,2,2,8,0,0,0,0,0,0,7,0,0,0,0,0,0,0,0,0,0,0,0,0,0,0
7,7,7,7,7,7,7,7,7,7,7,7,7,7,7,7,7,7,7,7,7,0,0,0,0,0,0,0,0,0,1,1,0,0,0,0,0,0,0,0,0,0,0,0,0,0,0,0,0,0,0,0,0,0,0,7,7,0,0,0,8,8,8,8,1,1,8,8,8,8,8,8,8,8,8,8,8,8,0,0,0,0,0,7,7,0,0,0,0,0,0,0,0,0,0,0,0,0,0,0
7,7,7,7,7,7,7,7,7,7,7,7,7,7,7,7,7,7,7,7,7,7,7,7,7,7,7,7,7,0,1,1,5,0,0,0,0,0,0,0,0,0,0,0,0,0,0,0,0,0,0,0,0,0,0,7,7,0,0,0,0,0,0,0,1,1,0,0,0,0,0,0,0,0,0,0,0,0,0,0,0,0,7,7,0,0,0,0,0,0,0,0,0,0,0,0,0,0,0,0
7,7,7,7,7,7,7,7,7,7,7,7,7,7,7,7,7,7,7,7,7,7,7,7,7,7,7,7,7,7,2,2,7,7,7,7,7,7,7,7,7,7,7,7,0,0,0,0,0,0,0,0,0,0,0,7,7,7,0,0,0,0,0,0,1,1,0,0,0,0,0,0,0,0,0,0,0,0,0,0,0,7,7,0,0,0,0,0,0,0,0,0,0,0,0,0,0,0,0,0
7,7,7,7,7,7,7,7,7,7,7,7,7,7,7,7,7,7,7,7,7,7,7,7,7,7,7,7,7,7,2,2,7,7,7,7,7,7,7,7,7,7,7,7,7,0,0,0,0,0,0,0,0,0,0,0,7,7,0,0,0,0,0,0,1,1,0,0,0,0,0,0,0,0,0,0,0,0,0,0,0,7,0,0,0,0,0,0,0,0,0,0,0,0,0,0,0,0,0,0
7,7,7,7,7,7,7,7,7,7,7,7,1,1,1,1,1,1,1,1,1,1,1,7,7,7,7,7,7,7,2,2,7,7,7,7,7,7,7,7,7,7,7,7,7,7,7,7,7,7,7,7,7,0,0,0,7,7,0,0,0,0,0,5,1,1,5,0,0,0,0,0,0,0,0,0,0,0,0,0,7,7,0,0,0,0,7,7,7,7,7,7,7,7,7,7,7,7,7,7
7,7,7,7,7,7,7,7,7,1,1,1,1,1,1,1,1,1,1,1,1,1,0,0,0,0,0,0,0,7,2,2,7,7,7,7,7,7,7,7,7,7,7,7,7,7,7,7,7,7,7,7,7,7,7,7,7,7,7,7,7,7,7,7,2,2,7,7,7,7,7,7,7,7,7,7,7,0,0,0,7,7,0,0,7,7,7,7,7,7,7,7,7,7,7,7,7,7,7,7
7,7,7,7,7,7,7,7,1,1,1,1,1,0,0,0,0,0,0,0,0,0,0,0,0,0,0,0,0,0,2,2,7,7,7,7,7,7,7,7,7,7,7,7,7,7,7,7,7,7,7,7,7,7,7,7,7,7,7,7,7,7,7,7,2,2,7,7,7,7,7,7,7,7,7,7,7,7,7,7,7,7,7,7,7,7,7,7,7,7,7,7,7,7,7,7,7,7,7,7
7,7,7,7,7,7,1,1,1,1,1,0,0,0,0,0,0,0,0,0,0,5,5,5,5,5,5,0,0,1,1,1,0,7,7,7,0,0,0,0,7,7,7,7,7,7,7,7,7,7,7,7,7,7,7,7,7,7,7,7,7,7,7,7,2,2,7,7,7,7,7,7,7,7,7,7,7,7,7,7,7,7,7,7,7,7,7,7,7,0,0,7,7,7,7,7,7,7,7,7
7,7,7,7,7,7,1,1,1,0,0,0,0,0,0,0,0,3,5,5,5,5,5,5,5,0,0,0,1,1,1,0,0,0,0,0,0,0,0,0,0,0,0,0,0,7,7,7,7,7,7,7,7,7,7,7,7,7,7,7,7,7,7,7,2,2,7,7,7,7,7,7,7,7,7,7,7,7,7,7,7,7,7,7,7,0,0,0,0,0,0,0,0,0,0,0,0,0,0,0
7,7,7,7,1,1,1,1,0,0,0,0,0,0,0,3,3,5,5,5,5,5,5,0,0,0,0,1,1,1,0,5,0,0,0,0,0,0,0,0,0,0,0,0,0,0,7,7,7,7,7,7,0,0,0,0,0,0,0,0,0,0,0,0,1,1,0,0,0,0,0,0,0,0,0,0,0,0,0,0,0,0,0,0,0,0,0,0,0,0,0,0,0,0,0,0,0,0,0,0
7,7,7,1,1,1,1,0,0,0,0,0,0,0,3,3,5,5,5,5,5,5,0,0,0,0,1,1,1,0,5,5,5,0,0,0,0,0,0,0,0,0,0,0,0,7,7,7,7,7,0,0,0,0,0,0,0,0,0,0,0,0,0,0,1,1,0,0,0,0,0,0,0,0,0,0,0,0,0,0,0,0,0,0,0,0,0,0,0,0,0,0,0,0,0,0,0,0,0,0
7,7,7,1,1,1,0,0,0,0,0,0,0,3,3,5,5,5,5,0,0,0,0,0,0,1,1,1,0,5,5,5,0,0,0,0,0,0,0,0,0,0,0,0,0,7,7,7,7,7,0,0,0,0,0,0,0,0,0,0,0,0,0,0,1,1,0,0,0,0,0,0,0,0,0,0,0,0,0,0,0,0,0,0,0,0,0,0,0,0,0,0,0,0,0,0,0,0,0,0
7,7,1,1,1,1,0,0,0,0,0,0,3,3,5,5,5,5,5,0,0,0,0,0,1,1,1,0,5,5,5,5,0,0,0,0,0,0,0,0,0,0,0,0,7,7,7,7,7,7,0,0,0,0,0,0,0,0,0,0,0,0,0,0,1,1,0,0,0,0,0,0,0,0,0,0,0,0,0,0,0,0,0,0,0,0,0,0,0,0,0,0,0,0,0,0,0,0,0,0
7,7,1,1,1,0,0,0,0,0,0,3,3,5,5,5,5,5,0,0,0,0,1,1,1,1,0,5,5,5,5,5,0,0,0,0,0,0,0,0,0,0,0,7,7,7,7,7,7,0,0,0,0,0,0,0,0,0,0,0,0,0,0,0,1,1,0,0,0,0,0,0,0,0,0,0,0,0,0,0,0,0,0,0,0,0,0,0,0,0,0,0,0,0,0,0,0,0,0,0
7,7,1,1,1,0,0,0,0,0,3,3,5,5,5,5,5,0,0,0,0,1,1,1,0,0,5,5,5,5,5,0,0,0,0,0,0,0,0,0,0,0,7,7,7,7,7,0,0,0,0,0,0,0,0,0,6,6,6,6,6,6,6,9,1,1,9,6,6,6,6,6,6,6,6,6,6,6,0,0,0,0,0,6,6,6,6,6,6,6,6,6,6,6,6,6,6,6,6,6
7,7,1,1,1,0,0,0,0,3,3,5,5,5,5,5,0,0,0,1,1,1,1,0,0,5,5,5,5,5,5,0,0,0,0,0,0,0,0,0,0,7,7,7,7,7,0,0,0,0,0,0,0,0,0,6,6,6,6,6,9,9,9,9,2,2,9,9,9,9,6,2,6,6,6,6,6,6,6,6,6,6,6,6,6,6,6,6,6,6,6,6,6,6,6,6,6,6,6,6
7,7,1,1,0,0,0,0,3,3,5,5,5,5,5,0,0,0,1,1,1,0,0,0,5,5,5,5,5,5,0,0,0,0,0,0,0,0,0,0,7,7,7,7,7,0,0,0,0,0,0,0,0,0,0,6,6,6,6,6,9,9,2,2,2,2,2,2,2,9,6,6,6,6,6,6,6,6,6,6,6,6,6,6,6,6,6,6,6,6,6,6,6,6,6,6,6,6,6,6
7,7,7,1,0,0,0,0,3,3,5,5,5,5,0,0,0,1,1,1,0,0,0,5,5,5,5,5,5,5,0,0,0,0,0,0,0,0,0,7,7,7,7,0,0,0,0,0,0,0,0,0,0,6,6,6,9,9,9,9,2,2,2,2,2,2,2,2,2,2,9,9,9,6,6,2,6,6,6,6,6,6,6,6,6,6,6,6,6,6,6,6,6,6,6,6,6,6,6,6
7,7,7,1,0,0,0,3,3,5,5,5,5,5,5,0,0,1,1,0,0,5,5,5,5,5,5,5,5,0,0,0,0,0,0,0,0,0,7,7,7,7,0,0,0,0,0,0,0,0,0,6,6,6,6,6,9,2,2,2,2,2,2,2,9,9,2,2,2,2,2,2,2,2,2,6,6,6,2,2,6,6,6,6,6,6,6,6,6,2,6,6,6,6,6,2,6,6,6,6
7,7,7,7,0,0,3,3,3,5,5,5,5,5,5,0,1,1,0,0,0,5,5,5,5,5,5,5,5,0,0,0,0,0,0,0,0,7,7,7,7,0,0,0,0,0,0,0,0,0,6,6,6,6,6,2,2,2,2,2,2,2,2,2,9,9,2,2,2,2,2,2,2,2,2,2,2,2,2,2,2,2,2,2,2,2,2,2,2,6,6,6,6,6,6,6,6,2,2,2
7,7,7,7,0,0,3,3,5,5,5,5,5,5,0,0,1,1,0,0,5,5,5,5,5,5,5,5,0,0,0,0,0,0,0,0,7,7,7,7,7,0,0,0,0,0,0,0,0,6,6,6,6,6,2,2,2,2,2,2,2,2,9,9,9,9,9,9,2,2,2,2,2,2,2,2,2,2,2,2,2,2,2,2,2,2,2,2,2,2,2,2,2,2,2,2,2,2,2,2
7,7,7,7,0,0,3,3,5,5,5,5,5,0,0,0,1,1,0,0,5,5,5,5,5,5,5,5,0,0,0,0,0,0,0,7,7,7,7,7,7,0,0,0,0,0,0,0,0,6,6,6,2,2,2,2,2,2,2,9,2,2,2,2,9,9,2,2,2,2,2,2,2,2,2,2,2,2,2,2,2,2,2,2,2,2,2,2,2,2,2,2,2,2,2,2,2,2,2,2
7,7,7,7,7,0,3,3,5,5,5,5,5,0,0,1,1,0,0,5,5,5,5,5,5,5,5,0,0,0,0,0,0,0,0,7,7,7,7,7,0,0,0,0,0,0,0,0,0,6,6,6,2,2,2,2,2,2,2,9,2,2,2,2,9,9,2,2,2,2,2,2,2,2,2,2,2,2,2,2,2,2,2,2,2,2,2,2,2,2,2,2,2,2,2,2,2,2,2,2
7,7,7,7,7,0,3,3,5,5,5,5,5,0,0,1,1,0,0,5,5,5,5,5,5,5,5,5,0,0,0,0,0,0,7,7,7,7,7,7,0,0,0,0,0,0,0,0,6,6,6,2,2,2,2,2,2,2,2,9,9,9,2,2,2,2,2,2,2,2,2,2,2,2,2,2,2,2,2,2,2,2,2,2,2,2,2,2,2,2,2,2,2,2,2,2,2,2,2,2
7,7,7,7,7,0,3,3,5,5,5,5,5,0,0,1,1,0,0,5,5,5,5,5,5,5,5,5,0,0,0,0,0,0,7,7,7,7,7,0,0,0,0,0,0,0,0,6,6,6,6,2,2,2,2,2,2,2,2,2,2,2,2,2,2,2,2,2,2,2,2,2,2,2,2,2,2,2,2,2,2,2,2,2,2,2,2,2,2,2,2,2,2,2,2,2,2,2,2,2
7,7,7,7,7,0,0,3,5,5,5,5,5,0,0,1,1,0,5,5,5,5,5,5,5,5,5,5,0,0,0,0,0,7,7,7,7,7,7,0,0,0,0,0,0,0,6,6,6,6,6,2,2,2,2,2,2,2,2,2,2,2,2,2,2,2,2,2,2,2,2,2,2,2,2,2,2,2,2,2,2,2,2,2,2,2,2,2,2,2,2,2,2,2,2,2,2,2,2,2
7,7,7,7,0,0,0,5,5,5,5,5,5,0,0,1,1,0,5,5,5,5,5,5,5,5,5,0,0,0,0,0,0,7,7,7,7,7,7,0,0,0,0,0,0,0,6,6,6,6,2,2,2,2,2,2,2,2,2,2,2,2,2,2,2,2,2,2,2,2,2,2,2,2,2,2,2,2,2,2,2,2,2,2,2,2,2,2,2,2,2,2,2,2,2,2,2,2,2,2
7,7,7,0,0,0,0,5,5,5,5,5,5,0,0,1,1,0,5,5,5,5,5,5,5,5,5,0,0,0,0,0,7,7,7,7,7,7,0,0,0,0,0,0,0,0,6,6,6,2,2,2,2,2,2,2,2,2,2,2,2,2,2,2,2,2,2,2,2,2,2,2,2,2,2,2,2,2,2,2,2,2,2,2,2,2,2,2,2,2,2,2,2,2,2,2,2,2,2,2
7,7,7,0,0,0,0,5,5,5,5,5,5,5,1,1,1,0,5,5,5,5,5,5,5,5,5,0,0,0,0,7,7,7,7,7,7,0,0,0,0,0,0,0,0,0,6,6,2,2,2,2,2,2,2,2,2,2,2,2,2,2,2,2,2,2,2,2,2,2,2,2,2,2,2,2,2,2,2,2,2,2,2,2,2,2,2,2,2,2,2,2,2,2,2,2,2,2,2,2
7,7,0,0,0,0,5,5,5,5,5,5,5,5,1,1,1,0,5,5,5,5,5,5,5,5,5,0,0,0,0,7,7,7,7,7,0,0,0,0,0,0,0,0,0,6,6,6,2,2,2,2,2,2,2,2,2,2,2,2,2,2,2,9,9,9,9,9,9,9,9,9,9,9,9,9,9,9,2,2,2,2,2,2,2,2,2,2,2,2,2,2,2,2,2,2,2,2,2,2
7,7,0,0,0,0,5,5,5,5,5,5,5,0,1,1,0,0,5,5,5,5,5,5,5,5,5,0,0,0,0,7,7,7,7,7,0,0,0,0,0,0,0,0,0,6,6,2,2,2,2,2,2,2,2,2,2,2,2,2,2,2,2,9,12,12,11,12,12,12,12,12,12,12,11,12,12,9,2,2,2,2,2,2,2,2,2,2,2,2,2,2,2,2,2,2,2,2,2,2
7,7,0,0,0,0,0,5,5,5,5,5,5,0,1,1,0,0,5,5,5,5,5,5,5,5,5,0,0,0,7,7,7,7,7,7,0,0,0,0,0,0,0,0,6,6,2,2,2,2,2,2,2,2,2,2,2,2,2,2,2,2,2,9,12,4,4,12,11,13,22,13,11,12,4,4,12,9,2,2,2,2,2,2,2,2,2,2,2,2,2,2,2,2,2,2,2,2,2,2
7,7,7,0,0,0,0,5,5,5,5,5,5,0,1,1,0,0,5,5,5,5,5,5,5,5,5,0,0,0,7,7,7,7,7,0,0,0,0,0,0,0,0,0,6,6,2,2,2,2,2,2,2,2,2,2,2,2,2,2,2,2,2,9,12,4,4,12,11,13,4,13,11,12,4,4,12,9,2,2,2,2,2,2,2,2,2,2,2,2,2,2,2,2,2,2,2,2,2,2
7,7,7,7,0,0,5,5,5,5,5,5,5,0,1,1,0,0,5,5,5,5,5,5,5,5,5,0,0,0,7,7,7,7,7,0,0,0,0,0,0,0,0,0,6,6,2,2,2,2,2,2,2,2,2,2,2,2,2,2,2,2,2,12,4,4,4,12,4,4,4,4,4,12,4,4,4,12,2,2,2,2,2,2,2,2,2,2,2,2,2,2,2,2,2,2,2,2,2,2
7,7,7,7,0,0,5,5,5,5,5,5,0,0,1,1,0,0,5,5,5,5,5,5,5,5,5,0,0,7,7,7,7,7,7,0,0,0,0,0,0,0,0,6,6,2,2,2,2,2,2,2,2,2,2,2,2,2,2,2,2,2,2,12,4,4,4,12,13,4,4,4,13,12,4,4,4,12,2,2,2,2,2,2,2,2,2,2,2,2,2,2,2,2,2,2,2,2,2,2
7,7,7,7,0,0,5,5,5,5,0,0,0,0,1,1,0,0,0,5,5,5,5,5,5,5,5,0,0,7,7,7,7,7,7,0,0,0,0,0,0,0,6,6,6,2,2,2,2,2,2,2,2,2,2,2,2,2,2,2,2,2,2,12,12,4,4,12,12,4,4,4,12,12,4,4,12,12,2,2,2,2,2,2,2,2,2,2,2,2,2,2,2,2,2,2,2,2,2,2
7,7,7,7,0,0,5,5,5,5,5,0,0,0,1,1,0,0,0,0,0,0,5,5,5,5,5,0,0,7,7,7,7,7,0,0,0,0,0,0,0,6,6,6,6,2,2,2,2,2,2,2,2,2,2,2,2,2,2,2,2,2,2,2,12,4,4,4,12,4,20,4,12,4,4,4,12,2,2,2,2,2,2,2,2,2,2,2,2,2,2,2,2,2,2,2,2,2,2,2
7,7,7,7,0,0,5,5,5,5,0,0,0,9,2,2,9,9,9,9,0,0,5,5,5,5,5,0,0,7,7,7,7,7,0,0,0,0,0,0,0,6,6,6,2,2,2,2,2,2,2,2,2,2,2,2,2,2,2,2,2,2,2,2,4,4,4,4,4,4,4,4,4,4,4,4,4,2,2,2,2,2,2,2,2,2,2,2,2,2,2,2,2,2,2,2,2,2,2,2
7,7,7,7,0,5,5,5,5,5,0,0,0,9,2,2,9,2,2,9,0,0,5,5,5,5,5,0,7,7,7,7,7,7,0,0,0,0,0,0,6,6,6,6,2,2,2,2,2,2,2,2,2,2,2,2,2,2,2,2,2,2,2,2,4,4,12,4,4,4,4,4,4,4,12,4,4,2,2,2,2,2,2,2,2,2,2,2,2,2,2,2,2,2,2,2,2,2,2,2
7,7,7,0,0,5,5,5,5,5,0,0,0,9,2,2,9,2,2,9,0,0,5,5,5,5,5,0,7,7,7,7,7,7,0,0,0,0,0,0,6,6,6,6,2,2,2,2,2,2,2,2,2,2,2,2,2,2,2,2,2,2,2,2,4,4,12,12,12,4,4,4,12,12,12,4,4,2,2,2,2,2,2,2,2,2,2,2,2,2,2,2,2,2,2,2,2,2,2,2
7,7,7,0,5,5,5,5,5,5,0,0,0,9,2,2,2,2,2,9,0,0,5,5,5,5,0,0,7,7,7,7,7,7,0,0,0,0,0,6,6,6,6,6,2,2,2,2,2,2,2,2,2,2,2,2,2,2,2,2,2,2,2,2,4,4,4,4,4,4,4,4,4,4,4,4,4,2,2,2,2,2,2,2,2,2,2,2,2,2,2,2,2,2,2,2,2,2,2,2
7,7,0,0,5,5,5,5,5,5,0,0,0,9,2,2,2,2,2,9,0,0,5,5,5,5,0,0,7,7,7,7,7,7,0,0,0,0,0,6,6,6,6,6,2,2,2,2,2,2,2,2,2,2,2,2,2,2,2,2,2,2,2,2,4,4,4,4,4,4,4,4,4,4,4,4,4,2,2,2,2,2,2,2,2,2,2,2,2,2,2,2,2,2,2,2,2,2,2,2
7,7,0,0,0,5,5,5,5,5,0,0,0,9,9,9,9,9,9,9,0,0,5,5,5,5,0,7,7,7,7,7,7,7,0,0,0,0,0,6,6,6,6,6,2,2,2,2,2,2,2,2,2,2,2,2,2,2,2,2,2,2,2,2,2,2,2,2,2,2,2,2,2,2,2,2,2,2,2,2,2,2,2,2,2,2,2,2,2,2,2,2,2,2,2,2,2,2,2,2
7,7,0,0,0,0,5,5,5,5,0,0,0,0,0,0,0,0,0,0,0,0,5,5,5,0,0,7,7,7,7,7,7,7,0,0,0,0,0,6,6,6,6,6,2,2,2,2,2,2,2,2,2,2,2,2,2,2,2,2,2,2,2,2,2,2,2,2,2,2,2,2,2,2,2,2,2,2,2,2,2,2,2,2,2,2,2,2,2,2,2,2,2,2,2,2,2,2,2,2
7,7,7,0,0,0,0,5,5,5,5,5,0,0,0,0,0,0,0,0,0,5,5,5,5,0,0,7,7,7,7,7,7,7,0,0,0,0,6,6,6,6,6,2,2,2,2,2,2,2,2,2,2,2,2,2,2,2,2,2,2,2,2,2,2,2,2,2,2,2,2,2,2,2,2,2,2,2,2,2,2,2,2,2,2,2,2,2,2,2,2,2,2,2,2,2,2,2,2,2
7,7,7,7,0,0,0,0,5,5,5,5,5,5,5,5,5,5,5,5,5,5,5,5,0,0,7,7,7,7,7,7,7,0,0,0,0,0,6,6,6,6,6,2,2,2,2,2,2,2,2,2,2,2,2,2,2,2,2,2,2,2,2,2,2,2,2,2,2,2,2,2,2,2,2,2,2,2,2,2,2,2,2,2,2,2,2,2,2,2,2,2,2,2,2,2,2,2,2,2
7,7,7,7,7,7,0,0,0,0,0,5,5,5,5,5,5,5,5,5,5,0,0,0,0,0,7,7,7,7,7,7,7,0,0,0,0,0,6,6,6,6,6,2,2,2,2,2,2,2,2,2,2,2,2,2,2,2,2,2,2,2,2,2,2,2,2,2,2,2,2,2,2,2,2,2,2,2,2,2,2,2,2,2,2,2,2,2,2,2,2,2,2,2,2,2,2,2,2,2
7,7,7,7,7,7,7,7,0,0,0,0,0,5,5,5,5,5,0,0,0,7,7,7,7,7,7,7,7,7,7,7,7,0,0,0,0,6,6,6,6,6,6,2,2,2,2,2,2,2,2,2,2,2,2,2,2,2,2,2,2,2,2,2,2,2,2,2,2,2,2,2,2,2,2,2,2,2,2,2,2,2,2,2,2,2,2,2,2,2,2,2,2,2,2,2,2,2,2,2
7,7,7,7,7,7,7,7,7,7,7,7,7,7,7,7,7,7,7,7,7,7,7,7,7,7,7,7,7,7,7,7,7,0,0,0,0,6,6,6,6,6,6,2,2,2,2,2,2,2,2,2,2,2,2,2,2,2,2,2,2,2,2,2,2,2,2,2,2,2,2,2,2,2,2,2,2,2,2,2,2,2,2,2,2,2,2,2,2,2,2,2,2,2,2,2,2,2,2,2
